9,9,9,9,9,9,9,9,9,9,9,9,9,9,9,9,9,9,9,9,9,9,9,9,9,9,9,9,9,9,9,9,9,9,9,9,9,9,9,9,9,9,9,9,9,9,9,9,9,9,9,9,9,9,9,9,9,9,9,9,9,9,9,9,9,9,9,9,9,9,9,9,9,9,9,9,9,9,9,9,9,9,9,9,9,9,9,9,9,9,9,9,9,9,9,9,9,9,9,9,9,9,9,9,9,9,9,9,9,9,9,9,9,9,9,9,9,9,9,9,9,9,9,9,9,9,9,9,9,9,9,9,9,9,9,9,9,9,9,9,9,9,9,9,9,9,9,9,9,9
9,8,8,8,8,8,8,8,8,8,8,8,8,8,8,8,8,8,8,8,8,8,8,8,8,8,8,8,8,8,8,8,8,8,8,8,8,8,8,8,8,8,8,1,1,1,1,1,1,1,1,8,8,8,8,8,8,8,8,8,8,8,8,8,8,8,8,8,8,8,8,8,8,8,8,8,8,8,8,8,8,8,8,8,8,8,8,8,8,8,8,8,8,8,8,8,8,8,8,1,1,1,1,1,1,1,1,1,1,1,1,1,1,1,1,1,1,1,1,8,8,8,8,8,8,8,8,8,8,8,8,8,8,8,8,8,8,8,8,8,8,8,8,8,8,8,8,8,8,9
9,8,8,8,8,8,8,8,8,8,8,1,8,8,8,8,8,8,8,8,8,8,8,8,8,8,8,8,8,8,8,8,8,8,8,8,8,8,8,8,1,1,1,1,1,1,1,1,1,1,1,1,1,1,8,8,8,1,1,1,1,1,1,1,1,1,8,8,8,8,8,8,8,8,8,8,8,8,1,8,8,8,8,8,8,8,8,8,8,8,8,8,8,8,1,1,1,1,1,1,1,1,1,1,1,1,1,1,1,1,1,1,1,1,1,1,1,1,1,1,1,1,1,1,8,8,8,8,8,8,8,8,8,8,8,8,8,8,8,8,8,8,8,8,8,8,8,8,8,9
9,8,8,8,8,8,8,8,8,8,1,1,8,8,8,8,8,8,8,8,8,8,8,8,8,8,8,8,8,8,8,8,8,8,8,8,1,1,1,1,1,4,4,4,4,4,4,4,4,4,4,4,1,1,1,1,1,1,1,1,1,1,1,1,1,1,1,1,8,8,8,8,8,8,8,8,8,8,1,1,8,8,8,8,1,8,8,8,8,8,8,8,1,1,1,1,1,1,1,1,1,4,4,4,4,4,4,4,4,4,4,4,4,4,4,4,4,4,4,4,4,1,1,1,1,8,8,8,8,8,8,8,8,8,8,8,8,8,8,8,8,8,8,8,8,8,8,8,8,9
9,8,8,8,8,8,8,8,8,8,1,1,8,8,8,8,8,8,8,8,8,8,8,8,8,8,8,8,8,8,8,8,8,8,1,1,1,1,4,4,4,4,4,4,4,4,0,4,4,4,4,4,4,4,1,1,1,4,4,4,4,4,4,4,1,1,1,1,1,8,8,8,8,8,8,8,8,8,8,1,1,8,8,1,1,1,1,8,1,1,1,1,1,1,1,1,4,4,4,4,4,4,4,4,4,4,4,4,4,4,4,4,4,4,4,4,4,4,4,4,4,4,4,1,1,1,8,8,8,8,8,8,8,8,8,8,8,8,8,8,8,8,8,8,8,8,8,8,8,9
9,8,8,8,8,8,8,8,8,8,1,1,8,8,8,8,8,8,8,8,8,8,8,8,8,8,8,8,8,8,8,8,1,1,1,1,1,4,4,4,4,4,0,0,0,0,0,4,4,4,4,4,4,4,4,4,4,4,4,4,4,4,4,4,4,4,1,1,1,1,8,8,8,8,8,8,8,8,8,1,1,1,1,1,1,1,1,1,1,1,1,1,1,1,4,4,4,4,4,4,4,4,4,4,4,0,0,0,0,0,0,0,0,0,0,4,4,4,4,4,4,4,4,4,1,1,1,8,8,8,8,8,8,8,8,8,8,8,8,8,8,8,8,8,8,8,8,8,8,9
9,8,8,8,8,8,8,8,8,8,1,1,1,8,8,8,8,8,8,8,8,8,8,8,1,1,1,8,8,8,8,8,1,1,1,1,1,4,4,4,0,0,0,0,0,0,0,0,0,4,4,4,4,4,4,4,4,4,0,0,0,0,4,4,4,4,4,4,1,1,8,8,8,8,8,8,8,8,8,8,1,1,1,1,1,1,1,1,1,1,1,1,4,4,4,4,4,4,4,4,4,0,0,0,0,0,0,0,0,0,0,4,0,0,0,0,0,0,0,4,4,4,4,4,1,1,1,1,8,8,8,8,8,8,8,8,8,8,8,8,8,1,1,1,1,8,8,8,8,9
9,8,8,8,8,8,8,8,8,8,1,1,1,8,8,8,8,8,8,8,8,8,1,1,1,1,8,8,8,8,8,1,1,1,1,1,4,4,4,0,11,11,11,11,11,11,11,11,11,0,4,4,4,4,4,4,0,0,0,0,0,0,0,0,0,4,4,4,1,1,1,8,8,8,8,8,1,1,1,1,1,1,1,1,1,1,1,1,1,4,4,4,4,4,4,4,4,0,0,0,0,0,0,0,0,0,0,0,0,0,0,0,0,0,0,0,4,0,0,0,4,4,4,4,4,1,1,1,1,8,8,8,8,8,8,8,8,8,8,8,1,1,1,1,1,8,8,8,8,9
9,8,8,8,8,8,8,8,8,8,1,1,1,8,8,8,8,8,8,8,1,1,1,1,8,8,8,8,8,8,8,1,1,1,1,1,4,4,0,0,11,10,10,10,10,10,10,10,11,0,4,4,4,4,4,0,0,0,0,12,0,0,0,0,0,0,4,4,4,1,1,8,8,8,8,8,8,1,1,1,1,1,1,1,1,1,1,4,4,4,4,4,4,4,0,0,0,0,0,0,0,0,0,0,0,0,0,4,0,0,0,0,0,0,0,0,0,0,0,0,0,0,4,4,4,4,1,1,1,8,8,8,8,8,8,8,8,8,8,8,1,1,1,1,1,1,8,8,8,9
9,8,1,8,8,8,8,8,8,8,1,1,1,1,8,8,8,8,1,1,1,1,1,8,8,8,8,8,8,8,8,1,1,1,1,1,4,4,0,0,11,10,10,10,10,10,10,10,11,0,4,4,4,4,4,4,0,0,0,0,0,0,4,0,0,0,4,4,4,1,1,8,8,8,8,8,8,8,1,1,1,1,1,1,1,4,4,4,4,4,0,0,0,0,0,0,0,0,0,0,0,0,0,0,0,0,0,0,0,0,0,4,0,0,0,0,0,12,0,0,0,0,0,4,4,4,1,1,1,1,8,8,8,8,8,8,8,8,8,8,1,1,1,1,1,1,8,8,8,9
9,8,1,1,8,8,8,8,8,8,1,1,1,1,1,8,8,1,1,1,1,1,8,8,8,8,8,8,8,8,8,1,1,1,1,1,4,4,0,0,11,10,10,10,10,10,10,10,11,0,0,4,4,4,4,4,4,4,4,0,0,0,0,0,0,0,4,4,4,1,8,8,8,8,8,8,8,8,8,1,1,1,1,1,4,4,4,4,0,0,0,0,0,0,0,0,0,0,0,0,0,0,0,4,0,0,0,0,0,0,0,0,0,0,0,0,0,0,0,0,0,0,0,4,4,4,1,1,1,1,8,8,8,8,8,8,8,8,8,8,1,1,1,1,1,1,1,8,8,9
9,8,1,1,1,1,8,8,8,8,1,1,1,1,1,1,1,1,1,1,8,8,8,8,8,8,8,8,8,8,8,1,1,1,1,1,4,4,4,0,11,11,11,11,10,11,11,11,11,0,0,4,4,4,4,4,0,0,0,0,0,0,0,0,0,4,4,4,4,1,8,8,8,8,8,8,8,8,8,1,1,1,1,4,4,4,4,0,0,0,0,0,0,0,0,4,0,0,0,0,0,0,0,0,0,0,0,0,0,0,0,0,0,0,0,0,0,0,0,0,0,0,0,0,4,4,4,1,1,1,8,8,8,8,8,8,8,8,8,8,8,1,1,1,1,1,1,8,8,9
9,8,1,1,1,1,1,1,1,1,1,1,1,1,1,1,1,1,1,1,1,1,1,1,1,1,1,1,1,8,8,1,1,1,1,1,1,4,4,0,0,4,0,0,0,0,0,0,0,0,0,4,4,4,0,0,0,0,0,0,0,0,0,0,4,4,2,2,1,1,8,8,8,8,8,8,8,8,1,1,1,1,4,4,4,4,0,0,0,0,0,0,0,0,0,0,0,0,0,0,0,0,0,0,0,4,0,0,0,0,0,0,0,4,0,0,0,4,0,0,0,0,0,0,0,4,4,1,1,1,8,8,8,8,8,8,8,8,8,8,8,1,1,1,1,1,1,8,8,9
9,8,8,1,1,1,1,1,1,1,1,1,1,1,1,1,1,1,1,1,1,1,1,1,1,1,1,1,8,8,8,8,1,1,1,1,1,4,4,4,0,0,0,0,0,0,0,0,0,0,4,4,4,4,0,0,0,0,0,0,0,0,0,0,4,2,2,3,1,1,8,8,8,8,8,8,8,8,1,1,1,4,4,4,4,0,0,0,0,0,0,0,12,0,0,0,0,0,0,0,0,0,0,0,0,0,0,0,0,0,0,0,4,4,0,0,0,0,0,0,0,0,4,0,0,4,4,1,1,1,8,8,8,8,8,8,8,8,8,8,8,1,1,1,1,1,1,8,8,9
9,8,8,8,1,1,1,1,1,1,1,1,1,1,1,1,1,1,1,1,1,1,8,8,8,8,8,8,8,8,8,8,8,1,1,1,1,1,4,4,4,0,0,0,0,0,0,0,0,4,4,4,4,0,0,0,0,0,0,0,0,0,0,4,4,2,3,1,1,1,8,8,8,8,8,8,8,8,1,1,1,4,4,4,0,0,0,0,0,0,0,0,0,0,0,0,0,0,4,0,0,0,0,0,0,0,0,0,0,0,0,0,0,0,0,0,0,0,0,0,0,0,0,0,0,0,4,4,1,1,1,8,8,8,1,1,8,8,8,8,8,1,1,1,1,1,8,8,8,9
9,8,8,8,8,8,1,1,1,1,1,1,1,1,1,1,1,1,1,1,1,8,8,8,8,8,8,8,8,8,8,8,8,8,1,1,1,1,1,4,4,4,0,0,0,0,0,0,4,4,4,0,4,0,0,0,0,4,0,0,0,0,4,4,4,2,3,1,1,8,8,8,8,8,8,8,8,8,1,1,0,4,4,0,0,0,0,0,4,0,0,0,0,0,0,4,0,0,0,0,0,0,0,0,0,0,0,0,4,4,4,4,4,4,4,4,4,0,0,0,0,0,0,0,0,0,4,4,1,1,1,1,1,1,1,1,8,8,8,8,8,8,1,1,1,8,8,8,8,9
9,8,8,8,8,8,8,8,1,1,1,1,1,1,1,1,1,1,1,1,1,1,1,1,8,8,8,8,8,8,8,8,8,8,1,1,1,1,1,1,4,4,4,4,4,0,0,0,0,0,0,0,0,0,0,0,0,0,0,0,0,0,4,4,2,2,3,3,1,1,8,8,8,8,8,8,8,8,1,1,0,4,4,0,0,0,0,0,0,0,0,0,0,0,0,0,0,0,0,0,4,4,4,4,4,4,4,4,4,4,4,4,4,4,4,4,4,4,4,0,0,0,0,0,0,0,0,4,4,1,1,1,1,1,1,1,8,8,8,8,8,8,8,8,8,8,8,8,8,9
9,8,8,8,8,8,8,8,8,8,1,1,1,1,1,1,1,1,1,1,1,1,1,1,1,1,8,8,8,8,8,8,8,8,8,1,1,1,1,1,1,1,4,4,4,0,0,0,0,0,0,0,0,0,0,0,0,0,0,0,0,0,0,2,2,3,3,3,1,1,8,8,8,8,8,8,8,1,1,1,0,4,0,0,0,0,0,0,0,0,0,0,0,0,0,0,0,0,0,4,4,4,4,4,4,4,4,4,4,4,4,4,4,4,4,4,4,4,4,4,4,4,0,0,0,0,0,0,4,4,4,1,1,1,1,1,8,8,8,8,8,8,8,8,8,8,8,8,8,9
9,8,8,8,8,8,8,8,1,1,1,1,1,1,1,1,1,1,1,1,1,1,1,1,1,1,1,8,8,8,8,8,8,8,8,8,1,1,1,1,1,1,1,1,4,4,0,0,0,0,0,0,0,0,0,0,0,0,0,0,0,0,3,2,3,3,3,3,1,1,8,8,8,8,8,8,8,1,1,1,0,2,0,0,0,0,0,0,0,0,0,0,0,0,0,0,0,4,4,4,4,4,4,4,4,4,4,4,4,4,4,4,4,4,4,4,4,4,4,4,4,4,4,0,0,0,0,0,0,0,4,4,4,1,1,1,1,8,8,8,8,8,8,8,8,8,8,8,8,9
9,8,8,8,8,8,8,1,1,1,1,1,1,1,1,1,1,1,1,1,1,1,8,8,8,1,1,1,8,8,8,8,8,8,8,8,8,8,8,8,1,1,1,1,1,4,4,4,0,0,0,0,0,0,0,0,0,0,0,0,3,0,3,3,3,3,3,3,1,1,8,8,8,8,8,8,8,1,1,1,0,2,2,0,0,0,0,0,0,0,0,0,0,0,0,0,4,4,4,4,4,4,4,4,4,4,4,4,4,4,4,4,4,4,4,4,4,4,4,4,4,4,4,4,0,0,4,0,0,0,4,4,4,4,1,1,1,1,8,8,8,8,8,8,8,8,8,8,8,9
9,8,8,8,1,1,1,1,1,1,1,1,1,1,1,1,1,1,1,1,1,8,8,8,8,8,1,1,1,8,8,8,8,8,8,8,8,8,8,8,8,1,1,1,1,1,4,4,4,0,0,0,0,0,0,0,0,0,2,2,3,3,3,3,3,3,3,3,1,1,1,8,8,8,8,8,8,1,1,0,0,2,2,0,0,0,0,0,0,0,0,0,0,0,4,4,4,4,4,4,4,4,4,4,4,4,4,4,4,4,4,4,4,4,4,4,4,4,4,4,4,4,4,4,0,0,0,0,0,0,4,4,4,4,4,1,1,1,8,8,8,8,8,8,8,8,8,8,8,9
9,8,8,1,1,1,1,1,1,1,8,8,8,1,1,1,1,1,1,1,1,1,8,8,8,8,8,8,1,8,8,8,8,8,8,8,8,8,8,8,8,8,1,1,1,1,1,4,4,4,4,0,0,0,0,0,2,2,2,3,3,3,3,3,3,3,3,3,1,1,1,8,8,8,8,8,8,1,1,0,0,0,2,0,0,0,0,4,0,0,0,0,0,0,0,4,4,4,4,4,4,4,4,4,0,0,0,4,4,4,4,4,4,4,0,0,4,4,4,4,4,4,4,4,4,0,0,0,0,0,0,4,4,4,4,4,1,1,1,8,8,8,8,8,8,8,8,8,8,9
9,8,1,1,1,1,8,8,8,8,8,8,1,1,1,1,1,1,1,1,1,1,1,8,8,8,8,8,8,8,8,8,8,8,8,8,8,8,8,8,8,8,8,8,8,1,1,1,4,4,4,4,0,2,2,2,2,3,3,3,3,3,3,3,3,3,3,1,1,1,1,8,8,8,8,8,1,1,1,0,0,0,2,2,0,0,0,0,0,0,0,0,0,0,4,4,4,4,4,4,0,0,0,0,0,0,0,0,4,4,4,0,0,0,0,0,0,0,0,4,4,4,4,4,4,0,0,0,0,0,0,0,4,4,4,4,4,1,1,8,8,8,8,8,8,8,8,8,8,9
9,8,8,8,8,8,8,8,8,8,8,8,1,1,1,1,8,8,1,1,1,1,1,8,8,8,8,8,8,8,8,8,8,8,8,8,8,8,8,8,8,8,8,8,8,8,8,1,1,1,2,2,2,2,3,3,3,3,3,3,3,3,3,3,3,3,1,1,1,1,8,8,8,8,8,8,1,1,1,0,0,0,2,2,0,0,0,0,0,0,0,0,0,0,4,4,4,4,4,0,0,0,0,0,0,0,0,0,4,4,4,0,0,0,0,0,0,0,4,4,4,4,4,4,4,4,0,4,0,0,0,0,4,4,4,4,4,1,1,8,8,8,8,8,8,8,8,8,8,9
9,8,8,8,8,8,8,8,8,8,8,1,1,1,1,1,8,8,8,1,1,1,1,8,8,8,8,8,8,8,8,8,8,8,8,8,8,8,8,8,8,8,8,8,8,8,8,8,8,1,1,1,3,3,3,3,3,3,3,3,3,3,3,3,1,1,1,1,1,8,8,8,8,8,1,1,1,1,1,1,0,0,2,2,0,0,0,0,0,0,0,0,0,0,4,4,4,4,0,0,0,0,0,0,0,0,0,0,0,4,4,0,0,0,0,0,4,4,4,4,4,0,0,4,4,4,0,0,0,0,0,0,0,4,4,4,4,1,1,1,8,8,8,8,8,8,8,8,8,9
9,8,8,8,8,8,8,8,8,8,8,1,1,1,1,8,8,8,8,8,1,1,1,1,8,8,8,8,8,8,8,8,8,8,8,8,8,8,8,8,8,8,8,8,8,8,8,8,8,8,1,1,1,1,1,1,1,1,1,1,1,1,1,1,1,1,1,1,1,8,8,8,8,8,1,1,1,1,1,1,0,0,0,2,0,0,0,0,0,0,0,0,0,4,4,4,4,4,0,0,0,0,0,0,4,0,0,0,4,4,4,0,0,0,0,4,4,0,0,0,0,0,0,4,4,4,0,0,0,0,4,0,0,0,4,4,4,1,1,1,8,8,8,8,8,8,8,8,8,9
9,8,8,8,8,8,8,8,8,1,1,1,1,8,8,8,8,8,8,8,8,1,1,1,8,8,8,8,8,8,8,8,8,8,8,8,8,8,8,8,8,8,8,8,8,8,8,8,8,8,8,1,1,1,1,1,1,1,1,1,1,1,1,1,1,1,1,1,8,8,8,8,8,8,8,8,1,1,1,1,0,0,0,2,0,0,0,0,0,0,0,0,0,4,4,4,4,4,4,0,0,0,0,0,4,4,4,4,4,4,4,0,0,0,0,4,0,0,0,0,4,4,4,4,4,4,4,0,0,0,0,0,0,0,4,4,4,4,1,1,8,8,8,8,8,8,8,8,8,9
9,8,8,8,8,8,8,8,1,1,1,1,8,8,8,8,8,8,8,8,8,1,1,1,8,8,8,8,8,8,8,8,8,8,8,8,8,8,8,8,8,8,8,8,8,8,8,8,8,8,8,8,8,1,1,1,1,1,1,1,1,1,8,8,8,8,8,8,8,8,8,8,8,8,8,8,8,1,1,1,0,0,0,2,0,0,0,0,0,0,0,0,0,4,4,4,4,4,4,4,0,0,0,0,0,0,4,4,4,0,0,0,0,0,0,0,0,0,0,4,4,4,4,4,4,4,4,0,0,0,0,0,0,0,0,4,4,4,1,1,1,8,8,8,8,8,8,8,8,9
9,8,8,8,8,8,8,8,1,1,8,8,8,8,8,8,8,8,8,8,8,8,1,8,8,8,8,8,8,8,8,8,8,8,8,8,8,8,8,8,8,8,8,8,8,8,8,8,8,8,8,8,8,8,8,8,8,8,8,8,8,8,8,8,8,8,8,8,8,8,8,8,8,8,8,8,8,1,1,1,0,0,0,0,0,0,0,0,0,0,0,0,0,4,4,4,4,4,2,4,0,0,0,0,0,0,0,0,0,0,0,0,0,0,0,0,0,0,0,4,2,2,4,4,4,4,4,0,0,0,0,0,0,12,0,4,4,4,1,1,1,8,8,8,8,8,8,8,8,9
9,8,8,8,8,8,8,8,8,8,8,8,8,8,8,8,8,8,8,8,8,8,4,4,4,4,4,4,4,8,8,8,8,8,8,8,8,8,8,8,8,8,8,8,8,8,8,8,8,8,8,8,8,8,8,8,8,8,8,8,8,8,1,8,8,8,8,8,8,8,8,8,8,8,8,8,8,8,1,1,1,0,0,0,0,0,0,0,0,0,0,0,0,4,4,4,4,4,2,2,0,0,0,0,0,0,0,0,0,0,0,0,0,0,0,0,0,0,0,2,2,2,4,4,4,4,4,0,0,0,4,0,0,0,0,4,4,4,1,1,1,8,8,8,8,8,8,8,8,9
9,8,8,8,8,8,8,8,8,8,8,8,8,8,8,8,8,8,8,8,4,4,4,4,4,4,4,4,4,4,4,4,8,8,8,8,8,8,8,8,8,8,8,8,8,8,8,8,8,8,8,8,8,8,8,8,8,8,8,8,8,1,1,1,1,8,8,8,8,8,8,8,8,8,8,8,8,1,1,1,1,0,0,0,0,0,0,0,12,0,0,0,0,0,4,4,4,4,2,2,2,2,0,0,0,0,0,0,0,0,0,0,0,0,0,0,0,0,2,2,2,2,4,4,4,4,4,0,0,0,0,4,0,0,0,4,4,4,1,1,1,8,8,8,8,8,8,8,8,9
9,8,8,8,8,8,8,8,8,8,8,8,8,8,8,8,8,8,8,8,4,4,4,4,4,0,0,0,0,0,4,4,4,4,8,8,8,1,1,1,8,8,8,8,8,8,8,8,8,8,8,8,8,8,8,8,8,8,8,8,8,1,1,1,1,1,8,8,8,8,8,8,8,8,1,1,1,1,1,1,1,0,0,0,0,0,0,0,0,0,0,0,0,0,0,4,4,4,2,2,2,2,2,2,2,2,2,2,0,0,0,0,2,2,2,2,2,2,2,2,2,2,2,4,4,4,4,0,0,0,0,0,0,0,0,4,4,4,1,1,1,8,8,8,8,8,8,8,8,9
9,8,8,8,8,8,8,8,8,8,8,8,8,8,8,8,8,8,4,4,4,4,0,0,0,0,0,0,0,0,0,0,4,4,4,4,2,1,1,1,1,1,1,1,8,1,1,1,8,8,8,1,1,1,1,1,8,8,8,8,8,1,1,1,1,1,8,8,8,8,8,8,8,8,8,1,1,1,1,1,1,0,0,0,0,0,0,0,0,0,0,0,0,0,0,4,4,2,2,2,2,2,2,2,2,2,2,2,2,2,2,2,2,2,2,2,2,2,2,2,2,2,2,4,4,4,4,4,0,0,0,0,0,0,0,4,4,4,1,1,1,8,8,8,8,8,8,8,8,9
9,8,8,8,8,8,8,8,8,8,8,8,8,8,8,8,8,4,4,4,4,0,0,0,0,0,0,0,0,0,0,0,0,0,4,4,2,2,2,2,1,1,1,1,1,1,1,1,1,1,1,1,1,1,1,1,1,8,8,8,8,8,1,1,1,1,8,8,8,1,8,8,8,8,8,1,1,1,1,1,1,0,0,0,0,0,0,0,0,0,0,0,0,0,0,4,4,2,2,2,2,2,2,2,2,2,2,2,2,2,2,2,2,2,2,2,2,2,2,2,2,2,2,2,4,4,4,4,0,0,0,0,0,0,0,4,4,4,1,1,1,8,8,8,8,8,8,8,8,9
9,8,8,8,8,8,8,8,8,8,8,8,8,8,8,8,8,4,4,4,0,0,0,0,0,0,13,0,0,0,0,0,0,0,0,4,0,2,2,2,2,2,0,0,0,0,0,0,0,0,0,1,1,1,1,1,1,8,8,8,8,8,8,1,1,1,8,8,8,1,8,8,8,8,8,8,1,1,1,1,1,0,0,0,0,0,0,0,0,0,0,0,0,0,0,4,2,2,2,2,2,2,2,2,2,2,2,2,2,2,2,2,2,2,2,2,2,2,2,2,2,2,2,2,4,4,4,4,0,0,4,4,0,0,0,0,4,4,1,1,1,1,8,8,8,8,8,8,8,9
9,8,8,8,8,8,8,8,8,8,8,8,8,8,8,8,4,4,4,0,0,0,0,0,0,0,0,0,0,0,0,0,0,0,0,0,0,0,0,2,2,2,2,2,0,0,0,0,0,0,0,0,0,0,1,1,1,1,8,8,8,8,8,8,8,8,8,8,8,1,1,8,8,8,8,8,1,1,1,1,1,0,0,0,0,0,0,0,0,0,0,0,0,0,0,4,2,2,2,2,2,2,2,2,2,2,2,2,2,2,2,2,2,2,2,2,2,2,2,2,2,2,2,2,2,4,4,4,4,4,0,0,0,0,0,0,4,4,1,1,1,1,8,8,8,8,8,8,8,9
9,8,8,8,8,8,8,8,8,8,8,8,8,8,8,4,4,4,0,0,0,0,0,0,0,0,0,0,0,0,4,0,0,0,0,0,0,0,0,0,2,2,2,2,2,2,2,2,0,0,0,0,0,0,0,1,1,1,1,8,8,8,8,8,8,8,8,8,8,1,1,1,8,8,8,1,1,1,1,1,1,0,0,0,0,0,0,0,0,4,0,0,0,0,0,2,2,2,2,2,2,2,2,2,2,2,2,2,2,2,2,2,2,2,2,2,2,2,2,2,2,2,2,2,2,4,4,4,4,0,0,0,0,0,0,0,4,4,1,1,1,1,8,8,8,8,8,8,8,9
9,8,8,8,8,8,8,8,8,8,8,8,8,8,8,4,4,4,0,0,0,0,0,0,0,4,4,0,0,0,4,4,0,0,0,0,0,0,0,0,0,0,0,0,2,2,2,2,2,2,2,0,0,0,0,0,1,1,1,8,8,8,8,8,8,8,8,8,8,8,1,1,1,1,1,1,1,1,1,1,1,0,0,0,2,0,0,0,0,0,0,0,0,0,0,0,2,2,2,2,4,4,0,0,0,0,2,2,2,4,4,0,0,0,0,2,2,0,0,0,0,0,0,2,2,2,4,4,4,0,0,0,0,0,0,0,4,4,1,1,1,1,8,8,8,8,8,8,8,9
9,8,8,8,8,8,8,8,8,8,8,8,8,8,4,4,4,0,0,0,0,0,0,0,0,0,0,0,0,0,0,0,0,0,0,0,0,0,0,0,0,0,0,0,0,0,2,2,2,2,2,2,0,0,0,0,0,1,1,1,8,8,8,8,8,8,8,8,1,1,1,1,1,1,1,1,1,1,1,1,0,0,0,0,2,0,0,0,0,0,0,0,0,0,0,0,0,0,0,4,4,4,0,0,0,0,0,2,4,4,4,0,0,0,0,0,0,0,0,0,0,0,0,0,0,0,0,0,0,0,0,0,0,4,0,0,4,4,4,1,1,1,8,8,8,8,8,8,8,9
9,8,8,8,8,8,8,8,8,8,8,8,8,8,4,4,0,0,0,0,0,0,4,4,0,0,0,0,0,0,0,0,0,0,0,0,0,0,4,4,0,0,0,0,0,0,0,0,0,2,2,2,2,0,0,0,0,0,1,1,1,8,8,8,8,1,1,1,1,1,1,1,1,1,1,1,1,1,1,0,0,0,0,2,2,0,0,0,0,0,0,0,0,4,0,0,0,0,4,4,4,0,0,0,0,0,0,0,4,4,4,0,0,0,0,0,0,0,0,0,0,0,0,0,0,0,0,0,0,0,0,0,0,4,4,0,0,4,4,1,1,8,8,8,8,8,8,8,8,9
9,8,8,8,8,8,8,8,8,8,8,8,8,4,4,4,0,0,0,0,0,0,0,0,0,0,0,0,4,4,0,0,0,0,0,0,0,0,0,0,0,0,0,0,0,0,0,0,0,0,0,2,2,2,0,0,0,0,0,1,1,1,1,1,1,1,1,1,1,1,1,1,1,1,1,1,1,1,0,0,0,0,0,2,2,0,0,0,0,0,0,0,0,4,4,0,0,0,4,4,4,0,0,0,0,0,0,0,4,4,4,0,0,0,0,0,0,0,0,0,0,0,0,0,0,0,0,0,4,4,0,0,0,4,0,0,0,4,4,1,1,8,8,8,8,8,8,8,8,9
9,8,8,8,8,8,8,8,8,8,8,8,8,4,4,0,0,4,4,0,0,0,0,0,0,0,0,0,0,0,0,0,0,0,0,4,4,0,0,0,0,0,0,0,0,0,0,0,0,0,0,0,0,2,2,0,0,0,0,0,1,1,1,1,1,1,1,0,0,0,0,0,0,0,0,0,0,0,0,0,0,0,2,2,0,0,0,0,0,0,0,0,0,0,4,4,4,4,4,4,4,0,0,0,0,0,0,0,4,4,0,0,0,0,0,0,0,0,0,0,0,0,0,0,0,0,0,0,4,0,0,0,0,4,0,0,4,4,4,1,1,8,8,8,8,8,8,8,8,9
9,8,8,8,8,8,8,8,8,8,8,8,8,4,4,0,0,0,0,0,4,4,0,0,0,0,0,0,0,0,0,0,0,0,0,0,0,0,0,0,0,0,0,0,0,0,0,0,0,0,0,0,0,2,2,2,0,0,0,0,0,0,1,1,1,0,0,0,0,0,0,0,0,0,0,0,0,0,0,0,0,2,2,2,0,0,0,0,0,4,0,0,0,0,4,4,4,4,4,4,0,0,0,0,0,0,0,0,4,4,0,0,0,0,4,0,0,0,0,0,0,0,0,0,0,0,0,0,0,0,0,0,0,0,0,0,4,4,1,1,1,8,8,8,8,8,8,8,8,9
9,8,8,8,8,8,8,8,8,8,8,8,4,4,4,0,0,0,0,0,0,0,0,0,0,0,0,0,0,0,0,0,0,0,0,0,0,0,0,0,0,0,4,0,0,0,0,0,0,0,0,0,0,0,0,0,0,0,0,0,0,0,0,0,0,0,0,0,0,0,0,0,0,0,0,0,0,2,2,2,2,2,2,0,0,0,0,0,0,0,0,0,0,4,4,4,4,4,0,0,0,0,0,0,0,0,0,4,4,4,0,0,0,0,0,4,0,0,0,0,4,4,4,4,0,0,0,4,4,4,4,0,0,0,0,0,4,4,1,1,1,8,8,8,8,8,8,8,8,9
9,8,8,8,8,8,8,8,8,8,8,8,4,4,4,0,0,0,0,0,0,0,0,0,0,4,4,4,4,4,4,0,0,0,0,0,0,4,4,0,0,0,4,4,0,0,0,0,0,0,0,0,0,0,0,0,0,0,0,0,0,0,0,0,0,0,0,0,0,0,0,0,0,0,2,2,2,2,2,2,2,2,0,0,0,0,0,0,0,0,0,0,4,4,4,4,0,0,0,0,0,0,0,4,0,0,0,4,4,0,0,0,0,0,0,0,0,0,0,4,4,4,4,4,4,4,4,4,4,4,4,0,0,0,0,0,4,0,1,1,8,8,8,8,8,8,8,8,8,9
9,8,8,8,8,8,8,8,8,8,8,4,4,4,4,0,0,0,0,0,0,0,0,0,4,4,4,4,4,4,4,4,4,4,0,0,4,4,4,0,0,0,0,0,0,0,0,0,0,0,0,0,0,0,0,0,0,0,0,0,0,0,0,0,0,0,0,0,0,0,0,0,2,2,2,2,2,2,2,0,0,0,0,0,0,0,0,0,0,0,0,4,4,4,4,0,0,0,0,0,0,0,0,0,0,0,4,4,4,0,0,0,0,0,0,0,0,0,0,4,4,4,4,4,4,4,4,4,4,4,4,0,0,0,0,0,0,0,1,1,8,8,8,8,8,8,8,8,8,9
9,8,8,8,8,8,8,8,8,8,8,4,4,4,0,0,0,0,0,0,0,0,0,0,4,4,4,0,4,4,4,4,4,4,4,4,4,4,0,0,0,0,0,0,0,0,4,4,0,0,0,0,0,0,0,0,0,0,0,0,0,0,0,0,0,0,0,0,0,0,0,0,0,0,0,0,0,0,0,0,0,0,0,0,0,0,0,0,0,0,0,4,4,4,0,0,0,0,0,12,0,0,0,0,0,4,4,4,4,0,0,4,0,0,0,0,0,0,4,4,4,4,4,4,4,4,4,4,4,4,4,0,0,0,4,0,0,0,1,1,8,8,8,8,8,8,8,8,8,9
9,8,8,8,8,8,8,8,8,8,4,4,4,0,0,0,0,0,0,0,0,0,0,0,4,4,0,0,0,0,0,0,4,4,0,4,4,0,0,0,0,0,0,0,0,0,0,4,0,0,0,0,0,0,0,0,0,0,0,12,0,0,0,0,0,0,0,0,0,0,0,0,0,0,0,0,0,0,0,0,0,0,0,0,0,4,0,0,0,0,0,4,4,4,0,0,0,4,0,0,0,0,0,0,4,4,4,4,0,0,0,4,4,0,0,0,0,4,4,4,4,4,4,4,4,4,4,4,4,4,0,0,0,4,0,0,0,0,1,1,1,8,8,8,8,8,8,8,8,9
9,8,8,8,8,8,8,8,8,8,4,4,4,0,0,0,0,0,0,0,0,0,0,0,0,0,0,0,0,0,0,0,0,4,4,4,0,0,0,0,0,0,0,0,0,0,0,0,0,0,0,4,0,0,0,0,0,0,0,0,0,0,0,0,0,0,0,0,0,0,0,0,0,0,0,0,0,0,0,4,0,0,0,0,0,4,0,0,0,0,0,4,4,0,0,0,0,0,0,0,0,0,0,4,4,4,4,0,0,0,0,4,0,0,0,0,0,4,4,4,4,4,4,4,0,0,0,0,0,0,0,0,0,0,0,0,0,0,1,1,1,8,8,8,8,8,8,8,8,9
9,8,8,8,8,8,8,8,8,4,4,4,0,0,0,4,0,0,0,4,4,0,0,0,0,0,0,0,0,0,0,0,0,0,0,0,0,0,0,0,0,0,0,0,0,0,0,0,0,0,0,4,0,0,4,4,0,0,0,0,0,0,0,0,0,0,0,0,0,0,0,0,0,0,0,0,0,4,4,4,0,0,0,4,4,4,0,0,0,0,0,4,4,4,0,0,0,0,0,0,0,0,4,4,4,4,0,0,0,0,0,0,0,0,0,0,0,4,4,4,4,4,4,0,0,0,0,0,4,0,0,4,4,0,0,0,0,0,0,1,1,1,8,8,8,8,8,8,8,9
9,8,8,8,8,8,8,8,8,4,4,0,0,0,0,4,4,0,0,0,0,0,0,0,0,0,0,0,0,0,0,0,0,0,0,0,0,0,0,0,0,0,0,0,0,12,0,0,0,0,0,0,0,0,0,0,0,0,0,0,0,0,0,0,0,0,0,0,0,0,0,0,0,4,0,0,0,0,0,0,0,0,0,4,4,0,0,0,0,0,0,4,4,4,4,0,0,0,4,4,4,4,4,4,0,0,0,0,0,0,0,0,0,0,0,0,0,4,4,4,4,4,0,0,0,0,0,4,0,0,0,0,0,0,0,0,0,0,2,1,1,1,1,8,8,8,8,8,8,9
9,8,8,8,8,8,8,8,8,4,4,0,0,0,0,0,0,0,0,0,0,0,0,0,0,0,0,0,0,4,0,0,0,0,0,0,0,0,0,0,0,0,4,4,0,0,0,0,0,0,0,0,0,0,0,0,0,0,0,0,0,0,0,0,0,0,0,0,0,0,0,0,4,4,0,0,0,0,0,0,0,0,0,0,0,0,0,0,0,0,0,0,4,4,4,4,4,4,4,4,4,4,4,0,0,0,0,0,0,0,0,4,4,0,0,4,0,0,0,0,0,0,0,0,0,0,0,0,0,0,0,0,0,0,0,0,0,2,2,1,1,1,1,8,8,8,8,8,8,9
9,8,8,8,8,8,8,8,8,4,0,4,0,0,0,0,0,0,4,0,0,0,12,0,0,4,0,0,0,4,4,0,0,0,0,0,0,0,0,0,0,0,0,4,4,0,0,0,0,4,4,0,0,0,0,0,0,0,4,0,0,0,4,4,0,0,0,0,4,0,0,0,0,0,0,0,0,0,0,0,0,0,0,0,0,0,0,0,0,0,0,0,0,4,4,4,4,4,4,4,4,0,0,0,0,0,0,0,0,0,4,4,0,0,0,4,0,0,0,0,0,0,0,4,4,0,0,0,0,0,4,4,4,4,0,0,0,2,3,1,1,1,1,8,8,8,8,8,8,9
9,8,8,8,8,8,8,8,4,4,0,0,0,0,0,0,0,0,4,4,0,0,0,0,0,4,4,0,0,0,0,0,0,0,0,0,0,0,0,0,0,0,0,0,0,0,0,0,0,0,0,0,0,0,0,0,0,0,0,4,0,0,0,0,0,0,0,0,4,0,0,0,0,0,0,0,0,0,0,0,0,4,0,0,0,0,0,0,0,0,0,0,0,0,0,4,4,4,4,0,0,0,0,0,0,0,0,0,0,4,4,4,0,0,0,0,0,0,0,0,12,0,0,0,0,0,0,0,4,4,4,4,4,4,0,0,0,2,3,1,1,1,1,1,8,8,8,8,8,9
9,8,8,8,8,8,8,8,4,4,0,0,0,0,0,0,0,0,0,0,0,0,0,0,0,0,0,0,0,0,0,0,0,0,4,4,0,0,0,4,0,0,0,0,0,0,0,0,0,0,0,0,0,0,0,0,0,0,0,0,0,0,0,0,0,0,0,0,0,0,0,0,0,0,0,0,4,4,0,0,0,4,4,0,0,0,4,4,0,0,0,0,0,0,0,0,0,0,0,0,0,0,0,0,4,4,0,0,0,4,4,4,4,0,0,0,0,0,0,0,0,0,0,0,0,0,0,4,4,4,4,4,4,4,0,0,0,2,3,3,1,1,1,1,8,8,8,8,8,9
9,8,8,8,8,8,8,8,4,4,0,0,0,0,0,0,0,0,0,0,0,0,0,0,0,0,0,0,0,0,0,0,0,0,0,0,0,0,0,0,4,0,0,0,0,4,4,4,0,0,0,0,0,0,0,0,0,0,0,0,0,0,0,0,0,0,0,0,0,0,0,0,0,0,0,4,4,0,0,0,0,0,0,0,0,4,4,4,0,0,0,0,0,0,0,0,0,0,0,4,0,0,0,0,0,0,0,0,0,0,4,4,4,4,4,4,4,0,0,0,4,0,0,0,0,0,4,4,4,4,4,4,4,4,0,0,2,2,3,3,1,1,1,1,8,8,8,8,8,9
9,8,8,8,8,8,8,8,4,4,0,0,0,0,0,0,4,0,0,0,0,4,0,0,0,0,0,0,4,4,0,0,0,0,0,0,0,0,0,0,0,0,0,0,0,0,4,4,0,0,0,0,0,0,0,0,0,0,0,0,0,0,0,0,0,0,0,0,0,0,0,0,0,0,0,0,0,0,0,0,0,0,0,4,4,4,4,0,0,0,0,0,0,0,0,0,0,0,0,4,4,0,0,0,0,0,0,0,0,0,0,0,0,0,0,0,4,4,4,4,4,0,0,0,0,4,4,4,4,4,0,0,0,0,0,2,2,3,3,3,1,1,1,8,8,8,8,8,8,9
9,8,8,8,8,8,8,8,4,4,4,0,0,0,0,0,0,0,0,0,0,4,4,0,0,0,0,0,0,0,0,0,0,0,0,0,0,0,0,0,0,0,0,0,0,0,0,0,0,0,0,0,0,0,0,4,4,0,0,0,0,0,0,0,12,0,0,0,0,0,0,0,0,0,0,0,0,0,0,0,0,0,4,4,4,4,0,0,0,0,0,4,0,0,0,0,0,0,0,0,0,0,0,0,0,0,0,0,0,0,0,0,0,0,0,0,0,4,4,0,0,0,0,0,4,4,4,4,4,0,0,0,0,0,0,2,3,3,3,3,1,1,8,8,8,8,8,8,8,9
9,8,8,8,8,8,8,8,8,4,4,0,0,0,0,0,0,0,0,0,0,0,0,0,0,0,0,0,0,0,0,0,4,4,4,4,4,4,4,4,4,4,4,0,0,0,0,0,0,0,0,0,0,0,0,0,4,4,0,0,0,4,4,0,0,0,4,4,0,0,0,0,4,4,4,4,4,4,4,4,4,4,4,4,4,4,0,0,0,0,0,0,4,0,0,0,4,4,4,4,4,4,4,4,0,0,0,0,0,0,0,0,0,0,0,0,4,4,0,0,0,0,4,4,4,4,4,4,4,4,0,0,0,0,2,2,3,3,3,1,1,1,8,8,8,8,8,8,8,9
9,8,8,8,8,8,8,1,1,4,4,0,0,0,12,0,0,0,0,0,0,0,0,0,0,0,0,0,0,0,0,4,4,4,4,4,4,4,4,4,4,4,4,4,4,4,4,4,0,0,0,0,0,0,0,0,0,4,0,0,0,0,0,0,0,0,0,0,0,0,4,4,4,4,1,1,1,1,4,4,4,4,4,4,4,4,4,4,0,0,0,4,4,4,4,4,4,4,4,4,4,4,4,4,4,4,4,4,4,0,0,0,0,0,0,0,0,0,0,0,0,0,4,4,4,4,0,4,4,4,4,0,0,0,3,3,3,3,3,1,1,1,8,8,8,8,8,8,8,9
9,8,8,8,8,8,8,8,1,1,4,4,0,0,0,0,0,0,0,0,0,0,0,0,0,0,0,0,0,4,4,4,4,1,1,1,1,1,1,1,4,4,4,4,4,4,4,4,4,4,4,4,4,0,0,0,0,0,0,0,0,0,0,0,0,0,0,0,4,4,4,1,1,1,1,1,1,1,1,1,1,1,1,1,1,4,4,4,4,4,4,4,4,4,1,1,1,1,1,1,1,1,1,1,4,4,4,4,4,4,4,4,4,4,0,0,0,0,0,0,0,0,0,0,0,0,0,4,4,4,0,0,0,0,3,3,3,3,3,1,1,1,8,8,8,8,8,8,8,9
9,8,8,8,8,8,8,8,1,1,4,4,0,0,0,0,0,0,0,0,0,0,0,0,0,0,0,4,4,4,4,1,1,1,1,1,1,1,1,1,1,1,1,1,1,1,1,1,4,4,4,4,4,4,4,0,0,0,0,0,0,0,0,0,4,4,4,4,4,1,1,1,1,8,1,1,8,1,1,1,1,1,1,1,1,1,1,1,1,1,1,1,1,1,1,1,1,1,1,1,1,1,1,1,1,1,1,4,4,4,4,4,4,4,4,4,0,0,0,0,0,4,0,0,0,0,0,0,0,0,0,0,3,3,3,3,3,3,1,1,1,1,1,8,1,1,1,1,8,9
9,8,8,8,8,8,8,8,8,1,1,4,4,4,0,0,3,3,3,3,3,3,3,3,3,4,4,4,4,4,1,1,1,1,8,8,8,1,1,1,1,1,1,1,1,1,1,1,1,1,1,1,4,4,4,4,4,4,0,4,4,0,0,4,4,4,4,1,1,1,1,1,8,8,8,8,8,8,8,8,8,1,1,1,8,8,1,1,1,1,1,1,1,1,1,1,8,8,1,1,1,1,1,1,1,1,1,1,1,1,1,1,1,1,1,1,1,1,1,0,0,4,4,0,0,0,0,0,0,0,0,3,3,3,3,3,3,1,1,1,1,1,1,1,1,1,1,8,8,9
9,8,8,8,8,8,8,8,8,8,1,1,1,4,4,3,3,3,3,3,3,3,3,3,4,4,4,4,1,1,1,8,8,8,8,8,8,8,8,8,8,8,1,1,1,1,1,1,1,1,1,1,1,1,4,4,4,4,4,4,4,4,4,4,1,1,1,1,1,1,1,8,8,8,8,8,8,8,8,8,8,8,1,1,8,8,8,1,1,8,8,8,8,1,1,1,8,8,8,8,1,1,8,8,8,1,1,1,1,1,1,1,1,1,1,1,1,1,1,1,0,0,0,0,0,0,0,0,2,0,3,3,3,3,3,3,3,1,1,1,1,1,1,1,1,1,8,8,8,9
9,8,8,8,8,8,8,8,8,8,1,1,1,1,3,3,3,3,3,3,3,3,4,4,4,4,1,1,1,1,8,8,8,8,8,8,8,8,8,8,8,8,8,8,8,1,1,1,1,1,1,1,1,1,1,1,1,4,4,4,4,4,1,1,1,1,1,1,8,8,8,8,8,8,8,8,8,8,8,8,8,8,8,8,8,8,8,8,1,1,8,8,8,8,8,1,8,8,8,8,8,8,8,8,8,1,1,1,1,1,1,1,1,8,1,1,1,1,1,1,1,2,2,2,2,2,2,2,2,3,3,3,3,3,3,3,1,1,1,1,1,1,1,1,1,8,8,8,8,9
9,8,8,8,8,8,8,8,8,8,1,1,1,1,1,1,1,1,1,1,1,1,1,1,1,1,1,1,1,8,8,8,8,8,8,8,8,8,8,8,8,8,8,8,8,8,8,1,1,1,1,1,1,1,1,1,1,1,1,1,1,1,1,1,1,8,8,8,8,8,8,8,8,8,8,8,8,8,8,8,8,8,8,8,8,8,8,8,8,8,8,8,8,8,8,1,1,8,8,8,8,8,8,8,1,1,1,1,1,8,1,1,8,8,8,8,8,8,1,1,1,2,2,2,3,3,3,3,3,3,3,3,3,3,3,1,1,1,1,1,1,1,8,8,8,8,8,8,8,9
9,8,8,8,8,8,8,8,8,8,8,1,1,1,1,1,1,1,1,1,1,1,1,1,1,1,1,8,8,8,8,8,8,8,8,8,8,8,8,8,8,8,8,8,8,8,8,1,1,1,1,1,1,1,1,8,8,8,1,1,1,1,8,8,8,8,8,8,8,8,8,8,8,8,8,8,8,8,8,8,8,8,8,8,8,8,8,8,8,8,8,8,8,8,8,8,8,8,8,8,8,8,8,8,8,8,1,1,8,8,8,1,1,8,8,8,8,8,8,1,1,1,1,1,1,1,1,3,3,3,3,3,3,1,1,1,1,1,1,1,1,8,8,8,8,8,8,8,8,9
9,8,8,8,8,8,8,8,8,8,8,8,1,1,1,1,1,1,1,1,1,1,1,1,1,1,8,8,8,8,8,8,8,8,8,8,8,8,8,8,8,8,8,8,8,8,8,8,1,1,1,1,8,8,8,8,8,8,8,8,8,8,8,8,8,8,8,8,8,8,8,8,8,8,8,8,8,8,8,8,8,8,8,8,8,8,8,8,8,8,8,8,8,8,8,8,8,8,8,8,8,8,8,8,8,8,1,1,8,8,8,8,8,8,8,8,8,8,8,8,1,1,1,1,1,1,1,1,1,1,1,1,1,1,1,1,1,1,1,1,1,1,8,8,8,8,8,8,8,9
9,8,8,8,8,8,8,8,8,8,8,8,8,1,1,1,1,1,1,1,1,1,1,1,1,8,8,8,8,8,8,8,8,8,8,8,8,8,8,8,8,8,8,8,8,8,8,8,8,1,8,8,8,8,8,8,8,8,8,8,8,8,8,8,8,8,8,8,8,8,8,8,8,8,8,8,8,8,8,8,8,8,8,8,8,8,8,8,8,8,8,8,8,8,8,8,8,8,8,8,8,8,8,8,8,8,8,1,8,8,8,8,8,8,8,8,8,8,8,8,8,1,8,8,8,1,1,1,1,1,1,1,1,1,1,1,1,1,1,1,1,1,1,1,8,8,8,8,8,9
9,8,8,8,8,8,8,8,8,8,8,8,8,8,1,1,1,1,1,8,8,8,1,1,8,8,8,8,8,8,8,8,8,8,8,8,8,8,8,8,8,8,8,8,8,8,8,8,8,8,8,8,8,8,8,8,8,8,8,8,8,8,8,8,8,8,8,8,8,8,8,8,8,8,8,8,8,8,8,8,8,8,8,8,8,8,8,8,8,8,8,8,8,8,8,8,8,8,8,8,8,8,8,8,8,8,8,8,8,8,8,8,8,8,8,8,8,8,8,8,8,8,8,8,8,8,8,8,8,8,8,8,1,1,1,1,1,1,1,1,1,1,1,1,1,1,8,8,8,9
9,8,8,8,8,8,8,8,8,8,8,8,8,8,8,1,1,8,8,8,8,8,8,1,8,8,8,8,8,8,8,8,8,8,8,8,8,8,8,8,8,8,8,8,8,8,8,8,8,8,8,8,8,8,8,8,8,8,8,8,8,8,8,8,8,8,8,8,8,8,8,8,8,8,8,8,8,8,8,8,8,8,8,8,8,8,8,8,8,8,8,8,8,8,8,8,8,8,8,8,8,8,8,8,8,8,8,8,8,8,8,8,8,8,8,8,8,8,8,8,8,8,8,8,8,8,8,8,8,8,8,1,1,8,8,8,1,1,1,1,1,8,8,8,1,1,8,8,8,9
9,8,8,8,8,8,8,8,8,8,8,8,8,8,8,1,1,8,8,8,8,8,8,8,8,8,8,8,8,8,8,8,8,8,8,8,8,8,8,8,8,8,8,8,8,8,8,8,8,8,8,8,8,8,8,8,8,8,8,8,8,8,8,8,8,8,8,8,8,8,8,8,8,8,8,8,8,8,8,8,8,8,8,8,8,8,8,8,8,8,8,8,8,8,8,8,8,8,8,8,8,8,8,8,8,8,8,8,8,8,8,8,8,8,8,8,8,8,8,8,8,8,8,8,8,8,8,8,8,8,8,1,8,8,8,8,8,8,8,8,8,8,8,8,8,8,8,8,8,9
9,8,8,8,8,8,8,8,8,8,8,8,8,8,8,8,1,8,8,8,8,8,8,8,8,8,8,8,8,8,8,8,8,8,8,8,8,8,8,8,8,8,8,8,8,8,8,8,8,8,8,8,8,8,8,8,8,8,8,8,8,8,8,8,8,8,8,8,8,8,8,8,8,8,8,8,8,8,8,8,8,8,8,8,8,8,8,8,8,8,8,8,8,8,8,8,8,8,8,8,8,8,8,8,8,8,8,8,8,8,8,8,8,8,8,8,8,8,8,8,8,8,8,8,8,8,8,8,8,8,8,1,8,8,8,8,8,8,8,8,8,8,8,8,8,8,8,8,8,9
9,8,8,8,8,8,8,8,8,8,8,8,8,8,8,8,8,8,8,8,8,8,8,8,8,8,8,8,8,8,8,8,8,8,8,8,8,8,8,8,8,8,8,8,8,8,8,8,8,8,8,8,8,8,8,8,8,8,8,8,8,8,8,8,8,8,8,8,8,8,8,8,8,8,8,8,8,8,8,8,8,8,8,8,8,8,8,8,8,8,8,8,8,8,8,8,8,8,8,8,8,8,8,8,8,8,8,8,8,8,8,8,8,8,8,8,8,8,8,8,8,8,8,8,8,8,8,8,8,8,8,8,8,8,8,8,8,8,8,8,8,8,8,8,8,8,8,8,8,9
9,9,9,9,9,9,9,9,9,9,9,9,9,9,9,9,9,9,9,9,9,9,9,9,9,9,9,9,9,9,9,9,9,9,9,9,9,9,9,9,9,9,9,9,9,9,9,9,9,9,9,9,9,9,9,9,9,9,9,9,9,9,9,9,9,9,9,9,9,9,9,9,9,9,9,9,9,9,9,9,9,9,9,9,9,9,9,9,9,9,9,9,9,9,9,9,9,9,9,9,9,9,9,9,9,9,9,9,9,9,9,9,9,9,9,9,9,9,9,9,9,9,9,9,9,9,9,9,9,9,9,9,9,9,9,9,9,9,9,9,9,9,9,9,9,9,9,9,9,9
